w=16
h=16
dir=330
################
#             S#
#    ^         #
#              #
#              #
##  ##       ^ #
#m   #         #
#    #   ##    #
#        #     #
#        #m    #
#        #     #
###  #   ##    #
#    #   #     #
#^       #h  ^ #
#    #   #     #
################

EEEE5EEE5EEE5EEE
E00000000000000E
E00000000000000E
5000000000000005
E00000000000000E
EE00EE000000000E
E0000E000000000E
50000E000EE00005
E00000000E00000E
E00000000500000E
E00000000E00000E
EEE00E000EE00005
E0000E000E00000E
E00000000500000E
E0000E000E00000E
EEEE5EEE5EEE5EEE
